s           #  ## #  #  ## #  #  ## #  #  ## #  #  ## #  #  ## #  #  ## #  #  ## #  #  ## 
  #     #   #  ## #   #  ## #   #  ## #   #  ## #   #  ## #   #  ## #   #  ## #   #  ## # 
  #  ## #   #  ## #   #  ## #   #  ## #   #  ## #   #  ## #   #  ## #   #  ## #   #  ## # 
  #         #  ## #  #  ## #  #  ## #  #  ## #  #  ## #  #  ## #  #  ## #  #  ## #  #  ## 
  #     #   #  ## #   #  ## #   #  ## #   #  ## #   #  ## #   #  ## #   #  ## #   #  ## # 
  #  ## #   #  ## #   #  ## #   #  ## #   #  ## #   #  ## #   #  ## #   #  ## #   #  ## # 
  #     #   #  ## #   #  ## #   #  ## #   #  ## #   #  ## #   #  ## #   #  ## #   #  ## # 
  #  ## #   #  ## #   #  ## #   #  ## #   #  ## #   #  ## #   #  ## #   #  ## #   #  ## # 
  #         #  ## #  #  ## #  #  ## #  #  ## #  #  ## #  #  ## #  #  ## #  #  ## #  #  ## 
  #     #   #  ## #   #  ## #   #  ## #   #  ## #   #  ## #   #  ## #   #  ## #   #  ## # 
  #  ## #   #  ## #   #  ## #   #  ## #   #  ## #   #  ## #   #  ## #   #  ## #   #  ## # 
  #     #   #  ## #   #  ## #   #  ## #   #  ## #   #  ## #   #  ## #   #  ## #   #  ## # 
  #  ## #   #  ## #   #  ## #   #  ## #   #  ## #   #  ## #   #  ## #   #  ## #   #  ## # 
  #         #  ## #  #  ## #  #  ## #  #  ## #  #  ## #  #  ## #  #  ## #  #  ## #  #  ## 
  #     #   #  ## #   #  ## #   #  ## #   #  ## #   #  ## #   #  ## #   #  ## #   #  ## # 
  #  ## #   #  ## #   #  ## #   #  ## #   #  ## #   #  ## #   #  ## #   #  ## #   #  ## # 
  #     #   #  ## #   #  ## #   #  ## #   #  ## #   #  ## #   #  ## #   #  ## #   #  ## # 
  #  ## #   #  ## #   #  ## #   #  ## #   #  ## #   #  ## #   #  ## #   #  ## #   #  ## # 
  #         #  ## #  #  ## #  #  ## #  #  ## #  #  ## #  #  ## #  #  ## #  #  ## #  #  ## 
  #     #   #  ## #   #  ## #   #  ## #   #  ## #   #  ## #   #  ## #   #  ## #   #  ## # 
  #  ## #   #  ## #   #  ## #   #  ## #   #  ## #   #  ## #   #  ## #   #  ## #   #  ## # 
  #     #   #  ## #   #  ## #   #  ## #   #  ## #   #  ## #   #  ## #   #  ## #   #  ## # 
  #  ## #   #  ## #   #  ## #   #  ## #   #  ## #   #  ## #   #  ## #   #  ## #   #  ## # 
  #         #  ## #  #  ## #  #  ## #  #  ## #  #  ## #  #  ## #  #  ## #  #  ## #  #  ## 
  #     #   #  ## #   #  ## #   #  ## #   #  ## #   #  ## #   #  ## #   #  ## #   #  ## # 
  #  ## #   #  ## #   #  ## #   #  ## #   #  ## #   #  ## #   #  ## #   #  ## #   #  ## # 
  #     #   #  ## #   #  ## #   #  ## #   #  ## #   #  ## #   #  ## #   #  ## #   #  ## # 
  #  ## #   #  ## #   #  ## #   #  ## #   #  ## #   #  ## #   #  ## #   #  ## #   #  ## # 
  #                                                                                       
  #     #   #  ## #   #  ## #   #  ## #   #  ## #   #  ## #   #  ## #   #  ## #   #  ## # 
  #  ## #   #  ## #   #  ## #   #  ## #   #  ## #   #  ## #   #  ## #   #  ## #   #  ## # 
  #     #   #  ## #   #  ## #   #  ## #   #  ## #   #  ## #   #  ## #   #  ## #   #  ## # 
  #  ## #   #  ## #   #  ## #   #  ## #   #  ## #   #  ## #   #  ## #   #  ## #   #  ## # 
  #         #  ## #  #  ## #  #  ## #  #  ## #  #  ## #  #  ## #  #  ## #  #  ## #  #  ## 
  #     #   #  ## #   #  ## #   #  ## #   #  ## #   #  ## #   #  ## #   #  ## #   #  ## # 
  #  ## #   #  ## #   #  ## #   #  ## #   #  ## #   #  ## #   #  ## #   #  ## #   #  ## # 
  #     #   #  ## #   #  ## #   #  ## #   #  ## #   #  ## #   #  ## #   #  ## #   #  ## # 
  #  ## #   #  ## #   #  ## #   #  ## #   #  ## #   #  ## #   #  ## #   #  ## #   #  ## # 
  #         #  ## #  #  ## #  #  ## #  #  ## #  #  ## #  #  ## #  #  ## #  #  ## #  #  f 