s           b  bb b  b  bb b  b  bb b  b  bb b  b  bb b  b  bb b  b  bb b  b  bb b  b  bb 
  b     b   b  bb b   b  bb b   b  bb b   b  bb b   b  bb b   b  bb b   b  bb b   b  bb b 
  b  bb b   b  bb b   b  bb b   b  bb b   b  bb b   b  bb b   b  bb b   b  bb b   b  bb b 
  b         b  bb b  b  bb b  b  bb b  b  bb b  b  bb b  b  bb b  b  bb b  b  bb b  b  bb 
  b     b   b  bb b   b  bb b   b  bb b   b  bb b   b  bb b   b  bb b   b  bb b   b  bb b 
  b  bb b   b  bb b   b  bb b   b  bb b   b  bb b   b  bb b   b  bb b   b  bb b   b  bb b 
  b     b   b  bb b   b  bb b   b  bb b   b  bb b   b  bb b   b  bb b   b  bb b   b  bb b 
  b  bb b   b  bb b   b  bb b   b  bb b   b  bb b   b  bb b   b  bb b   b  bb b   b  bb b 
  b         b  bb b  b  bb b  b  bb b  b  bb b  b  bb b  b  bb b  b  bb b  b  bb b  b  bb 
  b     b   b  bb b   b  bb b   b  bb b   b  bb b   b  bb b   b  bb b   b  bb b   b  bb b 
  b  bb b   b  bb b   b  bb b   b  bb b   b  bb b   b  bb b   b  bb b   b  bb b   b  bb b 
  b     b   b  bb b   b  bb b   b  bb b   b  bb b   b  bb b   b  bb b   b  bb b   b  bb b 
  b  bb b   b  bb b   b  bb b   b  bb b   b  bb b   b  bb b   b  bb b   b  bb b   b  bb b 
  b         b  bb b  b  bb b  b  bb b  b  bb b  b  bb b  b  bb b  b  bb b  b  bb b  b  bb 
  b     b   b  bb b   b  bb b   b  bb b   b  bb b   b  bb b   b  bb b   b  bb b   b  bb b 
  b  bb b   b  bb b   b  bb b   b  bb b   b  bb b   b  bb b   b  bb b   b  bb b   b  bb b 
  b     b   b  bb b   b  bb b   b  bb b   b  bb b   b  bb b   b  bb b   b  bb b   b  bb b 
  b  bb b   b  bb b   b  bb b   b  bb b   b  bb b   b  bb b   b  bb b   b  bb b   b  bb b 
  b         b  bb b  b  bb b  b  bb b  b  bb b  b  bb b  b  bb b  b  bb b  b  bb b  b  bb 
  b     b   b  bb b   b  bb b   b  bb b   b  bb b   b  bb b   b  bb b   b  bb b   b  bb b 
  b  bb b   b  bb b   b  bb b   b  bb b   b  bb b   b  bb b   b  bb b   b  bb b   b  bb b 
  b     b   b  bb b   b  bb b   b  bb b   b  bb b   b  bb b   b  bb b   b  bb b   b  bb b 
  b  bb b   b  bb b   b  bb b   b  bb b   b  bb b   b  bb b   b  bb b   b  bb b   b  bb b 
  b         b  bb b  b  bb b  b  bb b  b  bb b  b  bb b  b  bb b  b  bb b  b  bb b  b  bb 
  b     b   b  bb b   b  bb b   b  bb b   b  bb b   b  bb b   b  bb b   b  bb b   b  bb b 
  b  bb b   b  bb b   b  bb b   b  bb b   b  bb b   b  bb b   b  bb b   b  bb b   b  bb b 
  b     b   b  bb b   b  bb b   b  bb b   b  bb b   b  bb b   b  bb b   b  bb b   b  bb b 
  b  bb b   b  bb b   b  bb b   b  bb b   b  bb b   b  bb b   b  bb b   b  bb b   b  bb b 
  b                                                                                       
  b     b   b  bb b   b  bb b   b  bb b   b  bb b   b  bb b   b  bb b   b  bb b   b  bb b 
  b  bb b   b  bb b   b  bb b   b  bb b   b  bb b   b  bb b   b  bb b   b  bb b   b  bb b 
  b     b   b  bb b   b  bb b   b  bb b   b  bb b   b  bb b   b  bb b   b  bb b   b  bb b 
  b  bb b   b  bb b   b  bb b   b  bb b   b  bb b   b  bb b   b  bb b   b  bb b   b  bb b 
  b         b  bb b  b  bb b  b  bb b  b  bb b  b  bb b  b  bb b  b  bb b  b  bb b  b  bb 
  b     b   b  bb b   b  bb b   b  bb b   b  bb b   b  bb b   b  bb b   b  bb b   b  bb b 
  b  bb b   b  bb b   b  bb b   b  bb b   b  bb b   b  bb b   b  bb b   b  bb b   b  bb b 
  b     b   b  bb b   b  bb b   b  bb b   b  bb b   b  bb b   b  bb b   b  bb b   b  bb b 
  b  bb b   b  bb b   b  bb b   b  bb b   b  bb b   b  bb b   b  bb b   b  bb b   b  bb b 
  b         b  bb b  b  bb b  b  bb b  b  bb b  b  bb b  b  bb b  b  bb b  b  bb b  b  f 